********************************************************************************
*.................................E...........E................................*
*..............................................................................*
*..............................................................................*
*..............................................................................*
*..............................................................................*
*..............................................................................*
*..............................................................................*
*..............................................................................*
*..............................................................................*
*..............................................................................*
*..............................................................................*
*..............................................................................*
*..............................................................................*
*..............................................................................*
*..............................................................................*
*..............................................................................*
*..............................................................................*
*..............................................................................*
*..............................................................................*
*..............................................................................*
*..............................................................................*
*..............................................................................*
*.............................P................................................*
*..............................................................................*
*..............................................................................*
*..............................................................................*
*..............................................................................*
*..............................................................................*
********************************************************************************
